11  111  1
1   11   1
1  111  11
1   11   1
1111111111
11  111  1
1   11   1
1  111  11
1   11   1
1111111111